92
8
27 0 0 0 0 0 0 0 0 0 0 0 0 0 0 0 0 0 0 0 0 0 0 0 0 0 0 0 0 0 0 0 0 0 0 0 0 0 0 0 0 0 0 0 0 0 0 0 0 0 0 0 0 0 0 0 0 0 0 0 0 0 0 0 0 0 0 0 0 0 0 0 0 0 0 0 0 0 0 0 0 0 0 0 0 0 0 0 0 0 0 27 
27 0 0 0 0 0 0 0 0 0 0 0 0 0 0 0 0 0 0 0 0 0 0 0 0 0 0 0 0 0 0 0 0 0 0 0 0 0 0 0 0 0 0 0 0 0 0 0 0 0 0 0 0 0 0 0 0 0 0 0 0 0 0 0 0 0 0 0 0 0 0 0 0 0 0 0 0 0 0 0 0 0 0 0 0 0 0 0 0 0 0 27 
27 0 0 0 0 0 0 0 0 0 0 0 0 0 0 0 0 0 0 0 0 0 0 0 0 0 0 0 0 0 0 0 0 0 0 0 0 0 0 0 0 0 0 0 0 0 0 0 0 0 0 0 0 0 0 0 0 0 0 0 0 0 0 0 0 0 0 0 0 0 0 0 0 0 0 0 0 0 0 0 0 0 0 0 0 0 0 0 0 0 0 27 
27 0 0 0 0 0 0 0 0 0 0 0 0 0 0 0 0 0 0 0 0 0 0 0 0 0 0 0 0 0 0 0 0 0 0 0 0 0 0 0 0 0 0 0 0 0 0 0 0 0 0 0 0 0 0 0 0 0 0 0 0 0 0 0 0 0 0 0 0 0 0 0 0 0 0 0 0 0 9 0 9 0 0 0 0 0 0 0 0 0 0 27 
27 0 0 12 0 0 0 0 0 0 0 13 0 11 11 0 0 0 0 0 0 0 0 0 0 0 0 0 0 0 0 0 0 0 0 0 0 0 0 0 0 0 0 0 0 0 0 0 0 0 0 0 0 0 0 0 0 0 0 0 0 0 0 0 0 0 0 0 0 0 0 0 0 0 0 0 0 1 22 22 22 2 0 0 0 0 0 0 0 0 0 27 
27 0 0 0 0 0 0 0 0 0 0 0 1 22 22 2 0 11 11 0 14 0 0 0 0 0 15 0 0 0 0 0 0 10 0 16 0 0 0 0 0 0 0 0 0 0 0 0 0 0 0 0 0 0 0 0 0 0 0 0 0 0 0 0 9 0 13 0 0 0 0 0 0 0 0 0 1 22 6 23 5 22 2 0 0 0 0 0 0 0 0 27 
27 0 0 0 0 0 0 0 0 0 1 22 22 6 23 4 1 22 22 2 0 10 0 1 22 2 0 10 0 0 0 9 1 22 2 0 0 10 0 0 9 0 0 0 11 0 0 0 9 0 0 9 0 0 0 11 0 0 0 0 0 0 0 1 22 2 9 0 0 0 11 0 0 0 9 1 22 6 23 23 23 5 22 2 0 10 0 0 0 0 0 27 
22 22 22 22 22 22 22 22 22 22 22 6 23 23 23 20 20 23 5 22 22 22 22 22 7 22 22 22 22 22 22 22 22 7 22 22 22 22 22 22 22 22 22 22 22 22 22 22 22 22 22 22 22 22 22 22 22 22 22 22 22 22 22 22 7 22 22 22 22 22 22 22 22 22 22 22 6 23 23 23 23 23 5 22 22 22 22 22 22 22 22 22 
